山田と言います。	私の名前は田中です
生まれ月は？	８月ですよ〜
いいな〜	山田さんは？
10月です、ぼく＾＾	食欲の秋ですね
うん	焼き芋とか〜さんまとか〜
もしかして、食べるのが大好き的な？	ばれちゃいました？？
ふむ、バレバレですよ　笑	第一印象が〜w
あははｗ	食べるのが好きなのは隠せないですね
甘いものとか好き？	もっちろん！
おすすめのお店ってあったりする？	えーっとね
うん	エッグスンシングスってお店かな
どこ？	原宿、銀座、お台場とかにありますよ
そうなんだ！	パンケーキがね、すんごいの！
何？	ホイップクリームがタワーみたに盛られてて！
そうなんだ！	山田さんは？
らーめんが一番好きです！	そうなんですね！
趣味を教えてください	私はホットヨガが大好きです
ふむ	山田さんは？
踊りです	踊れるんですか？
うん	Breakingとかします